"a" = (/turf/simulated/mineral/volcanic/lava_land_surface,/area/lavaland/surface/outdoors)
"b" = (/turf/simulated/floor/plating/asteroid/basalt/lava_land_surface,/area/lavaland/surface/outdoors)
"c" = (/turf/simulated/wall/cult{baseturf = /turf/simulated/floor/plating/lava/smooth},/area/ruin/unpowered)
"d" = (/obj/effect/light_emitter,/mob/living/simple_animal/hostile/spawner/ash_walker,/turf/simulated/floor/engine/cult{baseturf = /turf/simulated/floor/plating/lava/smooth},/area/ruin/unpowered)
"e" = (/obj/effect/decal/cleanable/blood,/obj/effect/landmark/corpse/mob_spawn/ash_walker,/turf/simulated/floor/engine/cult{baseturf = /turf/simulated/floor/plating/lava/smooth},/area/ruin/unpowered)
"f" = (/turf/simulated/floor/engine/cult{baseturf = /turf/simulated/floor/plating/lava/smooth},/area/ruin/unpowered)
"g" = (/obj/effect/landmark/corpse/mob_spawn/ash_walker,/turf/simulated/floor/engine/cult{baseturf = /turf/simulated/floor/plating/lava/smooth},/area/ruin/unpowered)
"h" = (/obj/effect/decal/cleanable/blood,/obj/item/device/flashlight/lantern,/turf/simulated/floor/engine/cult{baseturf = /turf/simulated/floor/plating/lava/smooth},/area/ruin/unpowered)
"i" = (/obj/effect/decal/cleanable/blood,/turf/simulated/floor/engine/cult{baseturf = /turf/simulated/floor/plating/lava/smooth},/area/ruin/unpowered)
"j" = (/obj/item/weapon/pickaxe,/obj/item/weapon/pickaxe,/obj/structure/closet/crate/internals,/obj/item/weapon/pickaxe,/obj/item/weapon/pickaxe,/obj/item/weapon/pickaxe,/obj/item/weapon/storage/box/rxglasses,/turf/simulated/floor/engine/cult{baseturf = /turf/simulated/floor/plating/lava/smooth},/area/ruin/unpowered)
"k" = (/obj/effect/landmark/corpse/miner,/turf/simulated/floor/engine/cult{baseturf = /turf/simulated/floor/plating/lava/smooth},/area/ruin/unpowered)
"l" = (/obj/structure/closet/crate/radiation,/obj/item/device/flashlight/lantern,/obj/item/device/flashlight/lantern,/obj/item/device/flashlight/lantern,/obj/item/device/flashlight/flare,/turf/simulated/floor/engine/cult{baseturf = /turf/simulated/floor/plating/lava/smooth},/area/ruin/unpowered)
"m" = (/obj/structure/closet/crate/medical,/turf/simulated/floor/engine/cult{baseturf = /turf/simulated/floor/plating/lava/smooth},/area/ruin/unpowered)
"n" = (/obj/structure/closet/crate/hydroponics,/obj/item/weapon/storage/belt,/obj/item/weapon/scythe,/turf/simulated/floor/engine/cult{baseturf = /turf/simulated/floor/plating/lava/smooth},/area/ruin/unpowered)
"o" = (/obj/item/device/flashlight/lantern,/turf/simulated/floor/engine/cult{baseturf = /turf/simulated/floor/plating/lava/smooth},/area/ruin/unpowered)
"p" = (/obj/item/device/flashlight/seclite,/obj/item/device/flashlight,/obj/structure/closet/crate,/obj/item/device/flashlight,/obj/item/device/flashlight,/obj/item/device/flashlight,/turf/simulated/floor/engine/cult{baseturf = /turf/simulated/floor/plating/lava/smooth},/area/ruin/unpowered)
"q" = (/obj/item/device/flashlight/flare,/obj/item/device/flashlight/seclite,/obj/item/device/flashlight/seclite,/obj/item/device/flashlight,/obj/structure/closet/crate,/obj/item/device/flashlight,/obj/item/device/flashlight,/obj/item/device/flashlight,/turf/simulated/floor/engine/cult{baseturf = /turf/simulated/floor/plating/lava/smooth},/area/ruin/unpowered)
"r" = (/turf/simulated/wall/mineral/iron{baseturf = /turf/simulated/floor/plating/lava/smooth},/area/ruin/unpowered)
"s" = (/obj/item/weapon/twohanded/spear,/obj/structure/mineral_door/iron,/turf/simulated/floor/engine/cult{baseturf = /turf/simulated/floor/plating/lava/smooth},/area/ruin/unpowered)
"t" = (/obj/structure/mineral_door/iron,/turf/simulated/floor/engine/cult{baseturf = /turf/simulated/floor/plating/lava/smooth},/area/ruin/unpowered)
"u" = (/obj/structure/closet/crate,/obj/item/device/gps,/turf/simulated/floor/engine/cult{baseturf = /turf/simulated/floor/plating/lava/smooth},/area/ruin/unpowered)
"v" = (/obj/structure/closet/crate,/obj/item/weapon/storage/firstaid,/turf/simulated/floor/engine/cult{baseturf = /turf/simulated/floor/plating/lava/smooth},/area/ruin/unpowered)
"w" = (/obj/machinery/the_singularitygen,/turf/simulated/floor/engine/cult{baseturf = /turf/simulated/floor/plating/lava/smooth},/area/ruin/unpowered)
"x" = (/obj/structure/rack{icon = 'icons/obj/stationobjs.dmi'; icon_state = "minibar_left"; name = "skeletal minibar"},/turf/simulated/floor/engine/cult{baseturf = /turf/simulated/floor/plating/lava/smooth},/area/ruin/unpowered)
"y" = (/obj/structure/rack{icon = 'icons/obj/stationobjs.dmi'; icon_state = "minibar_right"; name = "skeletal minibar"},/turf/simulated/floor/engine/cult{baseturf = /turf/simulated/floor/plating/lava/smooth},/area/ruin/unpowered)
"z" = (/obj/item/weapon/shovel,/turf/simulated/floor/engine/cult{baseturf = /turf/simulated/floor/plating/lava/smooth},/area/ruin/unpowered)
"A" = (/obj/structure/closet/crate,/obj/item/weapon/storage/firstaid,/obj/item/weapon/storage/firstaid/tactical,/turf/simulated/floor/engine/cult{baseturf = /turf/simulated/floor/plating/lava/smooth},/area/ruin/unpowered)
"B" = (/obj/item/device/flashlight,/turf/simulated/floor/engine/cult{baseturf = /turf/simulated/floor/plating/lava/smooth},/area/ruin/unpowered)
"C" = (/obj/item/weapon/storage/toolbox/syndicate,/turf/simulated/floor/engine/cult{baseturf = /turf/simulated/floor/plating/lava/smooth},/area/ruin/unpowered)
"D" = (/obj/structure/closet/crate/miningcar,/turf/simulated/floor/plating/asteroid/basalt/lava_land_surface,/area/lavaland/surface/outdoors)
"E" = (/obj/item/weapon/twohanded/spear,/obj/structure/rack,/obj/item/weapon/twohanded/spear,/obj/item/weapon/twohanded/spear,/obj/item/weapon/twohanded/spear,/turf/simulated/floor/engine/cult{baseturf = /turf/simulated/floor/plating/lava/smooth},/area/ruin/unpowered)
"F" = (/obj/item/weapon/twohanded/spear,/obj/structure/rack,/turf/simulated/floor/engine/cult{baseturf = /turf/simulated/floor/plating/lava/smooth},/area/ruin/unpowered)
"G" = (/obj/structure/mineral_door/iron,/turf/simulated/floor/engine/cult{baseturf = /turf/simulated/floor/plating/lava/smooth; blocks_air = 1},/area/ruin/unpowered)
"H" = (/turf/simulated/wall/cult{baseturf = /turf/simulated/floor/plating/lava/smooth},/area/lavaland/surface/outdoors)
"I" = (/turf/simulated/floor/engine/cult{baseturf = /turf/simulated/floor/plating/lava/smooth; nitrogen = 24; oxygen = 13; temperature = 300},/area/lavaland/surface/outdoors)
"J" = (/obj/item/weapon/twohanded/spear,/obj/structure/table,/turf/simulated/floor/engine/cult{baseturf = /turf/simulated/floor/plating/lava/smooth},/area/ruin/unpowered)
"K" = (/obj/item/weapon/pickaxe,/turf/simulated/floor/engine/cult{baseturf = /turf/simulated/floor/plating/lava/smooth; nitrogen = 24; oxygen = 13; temperature = 300},/area/lavaland/surface/outdoors)
"L" = (/obj/structure/ore_box,/turf/simulated/floor/plating/asteroid/basalt/lava_land_surface,/area/lavaland/surface/outdoors)

(1,1,1) = {"
aabaaaaaaaaabb
aaaaaaaaaaaabb
aaaaccccccaaab
aaaacdefgcaaab
aaaacehifcaaab
baaccifffccaaa
baacjfkfflcaaa
aaacmnfopqcaaa
aaccrrstrrccaa
aacuvwffxyzcaa
aacAfffkfffcaa
aacffBffffCcaa
bDrEfFrGrrrraa
HIrJJFrIbIKLaa
HIrrrrrbbbbbaa
bbbIbbbbIbbIaa
IbbbbbIbIbbbaa
abbbbbbbIbbbaa
"}
